つかぬ	が	見当が
分らない	て	記憶しているが
出ない	も	分別も
して	を	決心を
這って行くと	て	我慢して
出来なくなった	が で	猶予が 始末で
出来ん	が	我慢が
してやってから	を	返報を
思っている	と	勉強家だと
している	を	昼寝を
分る	か	珍重されなかったかは
する	を	昼寝を
寝る	という	小供というのは
来た	が	わるい——猫が
泣き出すのである	は	小供は——
観察すれば	て	同居して
する	ば	観察すれば
加える	を	迫害を
するには	を	家族的生活を
いわれた	ば	剿滅せねばならぬと
思う	と	議論と
掠奪せらるるのである	は	御馳走は
思い出したから	で	我儘で
失敗した	で	我儘で
しよう	を	話を
したり	を	投書を
見えた	と	決心と
しないで	も	昼寝も
つかない	が	鑑定が
しているのを	を	話を
かける	ばかり	想像ばかりで
したら	を	写生を
していたら	を	昼寝を
禁じ得なかった	を	失笑するのを
したくて	が	欠伸が
見ると	を	彩色を
判然しないのである	から	写生したのだから
うしている	が	小便が
出来ぬ	が	猶予が
して	て	失敬して
した	を	欠伸を
甘んじて	も	漫罵も
立ったのを	に	小便に
分らない	か	増長するか
我慢するが	も	我儘も
した	を	報道を
ある	が	我慢するが
騒いで	が	小供が
出来ない	の	昼寝の
眺めていると	て	佇立して
しない	も	身動きも
しないと	を	挨拶を
おった	て	鼓動して
思われない	と	察すると
食ってるらしい	を	御馳走を
して	を	問答を
食えると	が	御馳走が
していると	を	雑談を
繰り返した	を	自慢話しを
ならないと	て に	発達しているつもりだが 比較には
していた	は	覚悟は
する	を	自慢を
謹聴していれば	に	感心したように
御しやすい	て	謹聴していれば
飲み込んだから	を	呼吸を
わるくするのも	て	弁護して
定めた	を	思案を
見せる	て	感心して
呈出した	は	質問は
いう	て	大息して
いねえぜ	って	とったって——
胡魔化して	に	加減に
あるく	を	御馳走を
食うよりも	を	御馳走を
なるかも知れない	と	要心しないと
した	を	大分放蕩を
したと	を	放蕩を
するべく	を	放蕩を
いう	を	元来放蕩家を
する	を	放蕩を
自任する	をもって	放蕩家をもって
力めているが	に従って を	忠告に従って 写生を
すると	を	写生を
分るようだ	など	変化などが
主張した	を	写生を
聞いて	を	対話を
なって	ものの	顧慮せざるもののごとく
大著述なる	て	忠告して
言ったら	と	出版させたと
繰り返したのは	で	演説会で
おった	て	傾聴して
ある	が	話が
写生して	て	注意して
出来るから	て	写生して
した	な を	相違ないなと 半分降参を
せぬようだ	は	写生は
惹いたのは	を	注意を
悪くなった	と	消沈と
尽した	は	紅葉は
休まないで	に	感心に
かよう	は	小供は
食わないから	も	御馳走も
劇しくなくなったと	が	動揺が
した	を	苦心を
見える	が	感服したが
わかるように	と	判然と
思うと	か	苦心するかと
出来るのである	が	応用が
至るまで	に	垂れ加減に
存しているにもかかわらず	が	区別が
いって	とか	向上とか
している	て を	行列して 勉強を
わかるはずであるのに	が て	意味が 一見して
認められなかった	を	存在を
すればよいのに	で	外出でも
立派になっているという	て	卒業して
行かぬが	が	合点が
聞いて	を	談話を
しました	を	御無沙汰を
はみ出している	へ	左右へ
なぐる	に	自慢そうに
やりましてねと	を	合奏会を
なると	くらい	三挺くらいに
して	を	勘定を
通る	を	往来を
書いてあったのを	に	諷刺的に
する	を	返事を
もしましょうか	で	散歩で
聞きたいと	より	陥落より
した	を	決心を
頂戴した	て	失敬して
云われる	って	頂戴したって
するという	を	間食を
失敬しては	に	留守中に
頂戴し	て	失敬しては
失敬している	て	頂戴しては
受けつつあると	を	仕付を
覚まして	が	小供が
睨み合っていたが	は	少らく両人は
食っている	て	拝見していると
すると	を	我儘を
平気ですましている	が	承知しないのであるが
する	を	返事を
書きつけた	て	注意していると
おったので	の	旅鴉のごとく
感ぜられたから	に	下落したように
出た	へ	御成道へ
求めつつあるのか	を	慰安を
付かぬ	が	見当が
至ると	に	我等猫属に
及ばぬと	に	保存するには
しているようだ	を	喧嘩を
断てと	を	是非香の物を
ある	は	源因は
疑なしという	は	本復は
限る	に	按腹揉療治に
愛していた	を	按摩術を
うけたと	を	治療を
顛倒しなければ	を	位置を
しにくいとか	が	根治が
いって	ば	顛倒しなければ
かかったような	に	昏睡病に
した	て	閉口して
食うなと	を	是非固形体を
運動させれば	て	呼吸して
健全になる	ば	運動させれば
しない	の	永持の
ほかならないと	は	病気は
した	を	議論を
して	を	弁解を
した	を	挨拶を
始めるなどというのは	を	晩酌を
する	を	遠征を
食いこぼした	の	小供の
いる	で	我儘で
出掛けた	に	散歩に
出ると	へ	往来へ
歌っている	は	小供は
する	ば	熟視すれば
つける	を	始末を
予知す	に を	直覚的に 適不適を
感じない	が	発明したが
見付けられた	に	小供に
大分見聞したが	も	実行も
食べかけて	を	御馳走を
云う	と	通過せざるべからずと
見廻した	て	経験して
した	を	失敗を
出た	と	訪問しようと
心得ている	が	相違ないが
する	て を	訪問して 話を
忘れて	て も	晴々して 苦労も
言うに	が	丸さ加減が
出来ん	が	形容が
微動するごとくに	て	反射して
思われる	に	微動するごとくに
する	で を	吾等猫属間で 挨拶を
いってくれる	て	尊敬して
している	を	返事を
出来ましたね	が	御化粧が
笑う	の	小供のようよと
笑うのだから	て	震動させて
した	を	返事を
得ないですよ	て	混雑して
した	を	降参を
問いかける	に	心配そうに
している	を	欠伸を
黙っていない	と	軽侮したと
して	を	挨拶を
しない	も	挨拶も
出来なかった	が	了解が
至ると	に	意味に
得られぬに	は	答弁は
俗了してしまう	て	震動させて
する	を	合図を
つかなかったが	で	応対で
困った	て	辟易して
終えねえ	に	始末に
阿魔だと	から	自慢なんだから
出来ねえんだが	が	承知が
来いと	に	是非いっしょに
行って	へ	西洋料理へ
御話しが	について	料理についての
分らん	が	意味が
這入る	へ	西洋料理へ
あるのですかな	で	大気で——全体
する	なんか	洋行なんか
思って	か	洋行なさったかと
なさる	を	形容を
表して	を	同情を
おらん	に	謝罪には
あるんですか	は	料理は
相談して参りましょうと	と	料理番と
行きましたよ	て	相談して参りましょうと
行きましたよ	に	相談に
読む	を	通信を
行っても	で	払底で
しないんです	を	返事を
表する	を	同情を
組織しまして	という	朗読会というのを
続けたいつもりで	て を	会合して 研究を
云うと	と	朗読会と
やるつもりです	なんか	創作なんかも
やりました	を	心中物を
やるんですか	か	朗読するのですかまたは
持って	を	同情を
いうと	と	心中物と
呈出した	を	質問を
見ませんが	は	研究は
加わったんですか	は	朗読家は
起さなくっちゃ	で	朗読でも
尋ねる	に	心配そうに
あるという	が	朗読会が
傍聴していた	て	探知して
称する	と	成功だと
笑わずにはいられない	と	想像すると
やるつもりなので	て	奮発して
仰ぎたいので	を	御尽力を
願いたいのでと	を	御捺印を
ならん	に	はあ賛成員に
意さえ御表し	の	賛成の
被下れば	て	御記入下さって
書き入れますと	へ	連判状へでも
這入る	と	失敬と
云うのが	と	乍憚御休心可被下候と
致さんと	を	御馳走を
する	を	返事を
表しない	て	苦心しているのじゃないかと
食べ続けにては	の	如く御馳走の
醸すべく	に	消化機能に
尽したる	を	研究を
貪ると同時に	に	不相当に
下せる	に	浴前に
申す迄もなく	は	増加は
居候えども	を	著述を
信じ居り	を	嘔吐方を
致し	に	右発見後に
やる	を	悪戯を
見たが	て	訪問して
思ったが	と	留守だと
寝ているという	で	病気で
受けていると	を	厚遇を
する	を	返事を
行くと	へ	診察場へ
分らん	は	病気は
殖えた	ばかり	病気ばかり
やる	を	含嗽を
つかん	も	想像も
やる	を	酷評を
使用する	て	感服しては
なったのも	に	病気に
見ようと	て	翻訳して
示して	を	催促状を
あるから	が	話が
云う	て	批評してやるからと
わからんね	が	意味が
預った	に	御返礼に
承知して	と	降参降参と
及ばん	に	恐縮するには
這入って来る	と	失礼しましたと
退治られた	て	拝聴して
する	を	挨拶を
云う	で	紹介で
するのが	を	講釈を
するんだいと	を	講釈を
買ってくれないと	を	苦心を
なって	で	朗読会で
やるつもりだから	て	招待して
願いたいって	を	是非御臨席を
喝采しようと	て	是非出席して
思ってるよ	と	喝采しようと
とる	を	復讐を
応用するのである	を	経験を
したよと	を	経験を
聞かし玉えと	か	経験か
つく	を	息を
聞くと	という	経験というのを
願うと	を	御在宿を
思ってね	の	小供のように
するなとか	を	夜間外出を
あるのさ	が	注意が
揚げなくては	で	大著述でもして
始まって	が	戦争が
して	を	辛苦を
出て	に	戦争に
列挙してあるのさ	じゃ	遊んじゃいないやね——
書こうと	で	返事でも
出掛けたと	に	散歩に
して	を	真似を
見ると	て	想像して
あって	が	無拠処差支えが
期すという	を	永日御面晤を
思った	て	安心して
近頃した	を	経験を
起った	くらい	同刻くらいに
ありまして	が	忘年会兼合奏会が
すんで	も	合奏も
聞きますので	か	御承知ですかと
口走るそうで	て	発熱して
思うように	が	睡眠剤が
話しなんですから	て	冷笑なさっては
なった	に	病気に
起したように	を	ストライキを
したのです	を	返事を
見つめているとまた	て	決心して
似ている	と	経験と
云う	と	感応と
したら	に	写生文に
なったかねと	は	病気は
まぜ返す	じゃ	同刻じゃないかと
云うのさ	て	参考して
する	を	談判を
予約するのが	て	交渉して
云うと	から	手続きだから
知りませんが	なんか	手続きなんか
踏まないで	を	手続きを
しないでも	を	見物を
すると	を	降参を
加える	を	註釈を
させたり	を	苦労を
させたりするばかりで	を	世話を
降りる	へ	靴脱へ
全快するだろうと	で	服薬でもしたら
して	を	相談を
帰らない	で と	当番で 全快するだろうと
履行する	て を	全快して 約束を
させるのも	を	覚悟を
云う	と	manyaslip'twixtthecupandthelipと
強くなる	で	失敗で
して	を	御化粧を
満足させて	を	希望を
出掛けてやろうと	て	満足させて
来た	て	奮発して行こうかなと
行った	に	注文通りに
ございますまいねと	て	外出致しても
なる	に	決して御心配に
出して	で	厳命で
出てくる	て	吶喊して
する	を	妨害を
ぐらぐらするのも	も	ぞくぞくするのも
全快したのは	が	病気が
嬉しがったりする	て	運動させて
承知していたが	で	我儘で
思われていた	て	承知していたが
聞いてから	を	話を
聞いていられないのだろう	て	沈黙して
あるだろう	ば	弄すれば
ほのめいて	に	談笑中にも
帯びてないのは	が	言語動作が
面白くなくなったので	が	談話が
なったが	は	門松注目飾りは
構わんが	で	留守でも
して	を	回向を
貰った	て	診察して
聞いている	が	弁解したかったが
するし	を	早死を
しているし	を	いたずらを
類似している	と	吾等猫属と
よると	に	説明に
聞き棄てて	を	談話を
した	を	身震いを
受けているだろう	を	御回向を
評するのも	と	失恋だと
呈出された	さえ	放逐論さえ
表するに	と	感謝すると同時に
するのは	を	虐待を
恥ずるであろう	は	鈍瞎漢は
寄せら	を	同情を
云う	て	糾合して
罵詈する	て	弄して
利かぬ	の	融通の
見ると	て	脱化して
せぬ	を	交際を
上りにくい	は	動作は
いた	て	注目していると
書き流した	で	言文一致体で
笑ったが	て	朗読して
描く	を	併行線を
気に入らないと	が	返事が
して	を	発見を
抹殺する	と	割愛しようと
しろと	に	御廃しにして
残らず	も	苦心も
なった	と	落第と
乞わず	も	案内も
生れる	を	苦労を
思って	と	見当だろうと
云う	て	卒業して
死んでしまった	て	勉強し過ぎて
給えと	よ	失敬するよ
待たず	も	返事も
命ぜられて	を	接待掛りを
見えて	と	不足だと
ならない	の	油断の
能いんですか	が	加減が
償おうと	を	損害を
可愛がってくれるかと	に を	——たまに 小供を
せず	は	道楽は
やっている	を	説教を
ならない	の	油断の
する	を	返事を
見計らって	に	加減に
ある	さ	削減させるさ
表していると	を	同情を
す	を	返答を
見えて	と	窮したと
出ていましたよ	が	評が
思えば	ね	次にね——出ずるかと
ありましたよ細君は	て	にこにこして
する	を	学問を
するような	を	弁護を
質問する	を	定義を
説明しにくいのですが	と	云うと——さようちと
付けなければならぬ	を	処置を
する	を	挨拶を
しないで	を	返事を
残らず	に	留守中に
守ると	を	沈黙を
するとか	を	演説を
やるから	を	稽古を
ある	や	いいやね——差支えなんぞ
分らんと	なんか	演説なんか
憤った	を	専断を
する	を	挨拶を
云う	と	頂戴しましょうと
願いますと	から を	稽古ですから 御遠慮なく御批評を
見ますと	て	研究して
して	に	釘付けに
用いたようでございます	に	処刑には
する	に を	退屈そうに 欠伸を
する	を	返事を
用いましたのは	として を	処刑として 絞殺を
想像して	を	絞殺を
見ますと	て	想像して
あります	に	執行するに
出来ないかも知れない	が	応用が
よりますと	に	平均性理論に
駄目になるのですが	が	力学的研究が
いらんから	は	遠慮は
云う話しです	と	往生さしたと
知れないぜと	ね	新工夫だね
論及するはずで	に	生理作用にまで
いたが	で	論及するはずで
するので	を	欠伸を
及ぼうと	に を	御報道に 失策物語を
貰わんと	て	区別しておいて
参るのは	ば	よせばいいのに——
云う	と	義士遺物保存会と
思った	と	弁護すると
這入って	へ	展覧場へ
来たんだって	て	見物していると
表する	を	同情を
見えて	と	我慢出来なくなったと
計る	を	調和を
忘れない	を	調和を
来る	に	報知に
這入って来る	は	所有主は
聳えて	の	堤防工事のように
対立する	に	左右に
行くと	て	謙遜して
表する	を	敬意を
終って	を	挨拶を
伺うんですが	を	御話を
利かぬ	の	融通の
なる	に	世話に
知らない	て	生活していようとは
する	を	返事を
致しました	を	失礼を
なると	に	御世話に
致しておりますと	を	御噂を
御辞儀までする	に	おまけに
笑っている	まで	御辞儀までする
願いましたそうで	を	御心配を
なりたいという	で に	関係で 御承知に
事でもありますか	という	恋着したというような
奏しない	ね	見当でしょうね
からまって来る	じゃ	御承知じゃありませんかと
しましょう	を	御話を
あって	が	演奏会が
白状しようじゃないか	ね	相違ないね
なったんです	に	御探知に
しに	を	喧嘩を
聞いている	を	談判を
守るの	を	沈黙を
やむを得ざるに至らしめられていたが	で	交換では
おっしゃるが	に	恋着したようにばかり
なって——	に	始め病気に
聞いたね	て	なって——
引き受けたんですか	で	承知で
悪くしたと	か	決心ですかねと
呈出する	て を	納得して 質問を
やっていますと	を	研究を
なれましょうかと	と	勉強すると
勉強しているんでございましょうか	の	地球の——
演説しましたと	て	勉強しているんでございましょうか
云う	と	演説しましたと
わからんので	が	意味が
及ぶと	に	運行に
あります	て	勉強しておりますまいか
合わんと	は	質問は
違いますが——	は	御話は
折ったそうじゃございませんか	が	違いますが——
浮かれ出す	こそ	質問こそ
笑う	て	注意しておきましょうと
あるよ	な	言われますまいな——ねえ迷亭
回復してくる	も	訳でもないでしょうから御安心なさいよと
やろうと	って	撰って
眺めていたが	と	拝見しましょうと
かくんでしょうね——	って に	撰って 撰りに
ないじゃありませんか	も	意味も
書き散らしてある	て	印刷してあって
えた	を	質問を
致しました	を	失礼を
する	を	要求を
すると	を	返事を
致しますからと	は	御礼は
いらんから	は	さあ遠慮は
なさるのは	など	讒訴などを
苛いわと	も	訳でもありませんから——
弁護しておく	と	弁護すると
限るよ	に	尊敬されるには
した	を	大著述を
した	を	噂を
起きてくるんです	だって	沙汰だって
縮めるには	を	睡眠時間を
思ってるんですからね	と	成功したと
する	を	返事を
来ました	が	返事が
云う	と	調達しろと
あるんです	に	命令中に
仕立てるのかい	て	注文してくれ
見える	て	発見して
いらあ	て	頂戴して
同意する	に	意見に
立ち至りますからな主人は	ちゃ	混同されちゃ
受けて	を	訪問を
拝聴し	を	談話を
知らぬ	て	買収して
しているのは	て	探偵しているのに
偵察してやらなくては	て	奮発して
している	を	撰を
あえてする	を	冒険を
至る	を	許諾を
振り	に	処に
逢う	を	報道を
及ぼして	て	使用して
ある	が に	覚悟が ——猫にも
閉口するが	は	霜解は
すてる	が	閉口するが
起して	を	大決心を
与うるだけが	を	自覚を
眺めて	を	建築を
してやろうじゃねえか	か	威嚇か
云うんだよ	って	喰わないのって——
思っているんだから	に	癖に——
示す	を	意味を
聞いて	を	話を
置かれない	て	感服して
祈らばやと	て	礼拝して
見たが	て	低頭して
違うようである	が	見当が
凝らす	を	息を
云います	で	話では
あるが	も	懸念も
せしめたる	を	未遂入水を
考えて	て	綜合して
惹かぬ	を	注意を
きく	に	噂に
分らない	かい	分ったかい——なに
取れない	だって	——なんだって
おひゃらかすよ	よ	御冗談なんだよ——
御云いな——	って へ	出ろって 電話口へ
存じておりますだって	へ	——へへへへへ
あずかりまして	に	毎度御贔屓に
笑ってるよ	や	ないやね——
切ってしまうよ	を	電話を
黙ってちゃ	か	困らないのかよ——
頂戴する	に	留守中に
する	を	挨拶を
染め出したのでございます	ので を	御求め遊ばしたので—— 番附を
謹聴している	か	発展するかと
出て行く	を	電話室を
出て	へ	往来へ
恋しくなる	は	探険中は
話し立てている	で	大胡坐で
してしまった	を	約束を
しないと	を	他言を
ひねくる	と	依頼なんでしょうとまた
言い懸けると	ね	所有主でね
云う	で	往来で
加える	を	批評を
煩わしたいと	て を	披瀝して 清聴を
やる	を	真似を
見ている	て	ぼんやりして
生ずるに	を	誤解を
計られませんから	て	混同なすっては
しておきます	を	御注意を
よりますと	で	——で
呈出した	て	蓄積して
抓みます	を	是非鼻を
与えますと	を	刺激を
応ずるが	に	刺激に
致します	て を	比例して 発達を
出来ますまいと	は	変化は
申し込む	を	抗議を
削り取られて	が で	左右が 作用で
変化して参ります——	と	隆起と
思います	て	紹介しておきたいと
やる	を	復讐を
思います	と	一言論及したいと
あっても	が	展覧会が
いらせられますが	て	所有して
失するの	を	比例を
ある	の	傍聴者の
入れようと	て	演繹して
生ずる	より	交叉より
話そう	だけ	結論だけ
あるかと	が	結論が
見ますと	て	参酌して
なりません	は	遺伝は
関せず	に	る説あるにも
膨脹するかも	て と共に	発達して 劇変と共に
知れません	か	膨脹するかも
よりますと	に	学理的論証に
なった	に	中御断念に
なったら	に	病気にでも
云う	と	——」「ハハハハハ艶罪と
飛び出す	へ	往来へ
出て	へ	往来へ
貰いたくない	を	出入するのを
受けないが	こそ	招待こそ
密着している	に	痙攣的に
ある	の	意味の
好む	を	議論を
行くまい	て	出来ている——
極める	と	所有と
差し支えないが	と	所有と
禁ずる	を	出入を
劃し限るのは	など	某々所有地などと
売買するなら	を	所有権を
入らぬ	は	差別は
する	を	遠慮を
通らない	は	議論は
する	を	探偵を
して	を	時分喧嘩を
よれば	に	処に
あるそうである	が	病気が
出来ぬ	は	油断は
出来ぬ	の	油断の
知れぬ	も	出入するのも
出来る	だけ	結論だけは
逞しゅうして	を	想像を
足るような	に	紹介するに
承	を	談話を
している	を	下宿を
煮え切らない——	で	訳で——
しているのでも	で	性分で——
していると	を	学問を
萌す	が	慢心が
すると	を	貧乏を
出ますから——	で	怪しからん訳で——
おりますよ	から	出ますから——
起るのだから	から	我儘から
出来た	が	真似が
変になってるんですよ	って	追っ懸けたってんです——
受けても	を	侮辱を
しましたよ	を	喧嘩を
了えないじゃありませんか	に	始末に
云えると	を	出鱈目を——
くる	から	道楽から
持たせてやったんです	て	忌々しくって——
云ったら——	から	御礼だから
欠いて	て	這入ってしまったって——言い草に
鑑定する	を	出所を
云う	と	今度東京勤務と
掛けた	を	御心配を
承諾する	を	依頼を
なる	に	世話に
いので	て	発展してくるな
なるような	に	御馳走に
聞いている	か	依頼するかなと
者ではありませんからな	の	容喙するべきはずの
していて	を	同宿を
見てくれんか	が	御依頼するのだが
張るのは	から	なるからな——
するのは	を	抵抗を
ある	の	教育の
碌々聞く	で	始末で
聞けば	も	談話も
出て	へ	往来へ
買って来たのであるが——	で	注文で
遭遇しつつある	て	買って来たのであるが——
化けるまで	て	経過して
申すのが	て	沙汰であって
思えない	つつ	廻転しつつあるかも知れないが
どうでもなる	で	解釈次第で
乗じて	か	了見か
乾かす	を	洗髪を
持って来たのかも知れない	へ	見当へ
動かさなければならない	を	是非共眼を
始めて	を	観察を
契った	が	——主人が
輝いている	て	反射して
なした	を	大発見を
見た	に	小供心に
ある	が	聯想が
恐れた	を	露見を
知れん	かも	伝染するかも
ぷりぷりする	わ	伝染しますわと
して	を	試験を
するが	も	我慢も
なったんじゃありませんか	で	承知で
延びるかと	が	相違ないが
なさるのねと	なんて	延びるなんて——
すまさんと	で に	返答次第では 分には
譲って	を	喧嘩を
苦しむ	に	説明に
命ぜられた	を	随行を
破る	を	平均を
破る	を	平均を
破壊する	を	平均を
洩らさないかと	て	処分して
出来ぬのである	が	上下し得るであろうが
しなかったが	も	報知も
かける	を	質問を
あるはずだったが	が	小供が
出来て	が	勉強が
云えんがね	ばかり	まさか——そうばかりも
する	を	情死を
通せないから——	ば	覚悟でなければやり
困る	ちゃ	解釈しちゃ
受けに	を	試験を
来した	を	大変化を
思い出せない	て	あって来たんだがね——あの
した	は	世話は
やって来たのさ	から	ないからね——
異にしている	を	撰を
したのは	を	喧嘩を
云わねばならぬ	が と	相違ないが 沙汰と
思っている	は	——苦沙弥先生は
し	も	——も
来たがってるんだろうじゃないか	でも ね	何でも——え 何だね——
すればいいつもりで	さえ	復命さえ
云ったよ	が	——細君が
聞いて	を	解釈を
せず	も	返答も
出来そうな	の	判断の
云っちゃ	と	——いや身分と
云う	と	——財産と
揉んでるのは	くらい	出張するくらい
与える	を	説明を
出来たらしいので	が	納得が
喰う	て を	まごまごしているとまた 吶喊を
あるから	が	安心したが
云うと	と	欲しい——資格と
なったら	に	——博士に
誤解しちゃ	じゃ	次第じゃない——
いかん	ちゃ	誤解しちゃ
受けるような	て	呈出して
思われて来る	も	請求するのも
してやりたくなる	に	依頼通りに
聞かん	と	判然と
きいていると	に	代理に
すれば	を	噂を
云う	て	拝見して
思った	と	成立し得ると
やるのが	を	問答を
明かに	も	芝居も
したい	は	長生は
云う	と	遠慮と
つかぬ	が	見当が
したが	は	返事は
持ってるよ	だって	田舎者だって——
出る	て	伝染して
して	を	外出を
号して	と	運動と
出て	て	号して
なるから	に	妨害に
起せと	の	是非元のように
専攻するつもりだから	ぜ	こうだぜ——
供さなければならん	て に	写生しておいて 参考に
すべき	に	学問に
引き裂いてしまった	を	写生帖を
振わなくなったのも	て	頓挫して
履行した	なんか	約束なんか
受けると	を	詰問を
すると	を	著述を
しようと	を	賭を
奢りっ	を	西洋料理を
したような	を	賭を
奢る	なんか	西洋料理なんか
有りついたなと	に	西洋料理に
すまして	を	契約履行を
する	を	質問を
奢る	など	西洋料理などを
出来ん	が	油断が
見ているかも知れない	て	是非通知してやるがいい
通じない	が	意味が
受けた	を	説法を
した	を	先日喧嘩を
塗ってやりたい	に	彫刻には
除けにして	は	合図は
したが	を	研究を
相変らず	と	写生してやろうと
せん	は	軟化は
せん	は	軟化は
出して	に	競技に
明記して	を	説明を
救い出してくれた	て	明記して
いかん	て	謹聴していなくちゃ
おいて得る	に	競技に
過ぎんのである	に ば	活動紙幣に 形容するならば
ぶら下げて	て	卒業して
し	も	——も
見給え——	て	爆発して
出て来ないので	は	——」迷亭は
あったって	など	活動切手などは
あしらって	に	好加減に
避けるのが	は	抵抗は
心得ている	は	口論は
ある	に	実行に
達せられたのである	ば	進捗すれば
達せられるのである	ば	進捗すれば
うけ	を	依頼を
有するかと	を	心理作用を
奮闘したじゃないか	に	辟易するに
した	を	講義を
応ずる	に	攻撃に
ある	が	評論家であるが
離れたので	が	話が
ならなくてね	が は	油断が 談話は
立ち懸けると	と	失敬すると
帰る	と	散歩しようと
鼓吹する	を	写生文を
価する	に	描写に
猫といえども	は	休養は
寝る	は	小供は
吹くのが	で	下宿で
与える	を	刺激を
遭逢した	に	心的変化に
云う	ば	回顧すれば
云う	と	恋慕したと
欲するのみである	を	休養を
鳴る	で	病気で
する	を	倹約を
弁じているのは	て	閉塞して
反り返っている	に	復讐に
云わず	つつ	維持しつつ
乞わず	も	案内も
考えた	ながら	蹲踞まりながら
抜けるであろうか	て	通過して
出た	は	——足音は
出ない	のみ も	廻転するのみで 分別も
凝らして	を	息を
飛出そうと	から	我慢出来んから
煩わしたい	て	開陳して
出来る	が	解釈が
積んで	を	観察を
傾いた	に	承認するように
作り上げられている	ば	換言すれば
出来んのである	は	変化は
求めた	て を	消耗して 変化を
受負った	を	製造を
云えば	から	観察点から
出来る	が て	解釈が 証明しているとも
出来るだろうと	が	断定が
云うが	と	製造したと
示した	を	変化を
見る	を	左右を
あらわすのが	を	変化を
困難かも知れぬ	は	注文するのは
伝習する	で	模傚主義で
生じてくるのは	に を	発音に 変化を
出来ぬ	の	区別の
生ぜしめたのは	を	変化を
したか	を	議論を
出れば	が	質問が
疑っていたのに	について	製作について
描いていた	て	想像して
展開した	に	左右に
足る	に	吸収するに
譲らない	と において	観察すると 作用において
動かされて	に	説法に
予想して	を	発展を
安心した	て	予想して
見済して	て	熟睡しているのを
驚いた	に	模写であるには
した	に	釘付けに
使う	に	煮物に
云う	と	適不適と
合して	と	予期と
要する	を	休養を
している	を	対談を
つかなかったのですな	で	睡眠中で
している	に対して を	質問に対して 相談を
している	を	問答を
して	を	戸締りを
見たって	て	——いや這入って
かくから	を	盗難告訴を
するような	でも	喧嘩でも
出て来んじゃないか	は	あとは——
聞かして	を	意味を
ある	も	意味も
せんと	を	告訴を
したって	を	告訴を
書いて	を	盗難告訴を
なさるんですから	は	告訴は
ふいと	と	廃そうと
上ってくる	が	寄贈者多々良三平君が
訪問して	から	関係から
帰るくらい	て	訪問して
覚えていて	を	約束を
して	を	真似を
して	を	真似を
すると	を	国自慢を
這入って——	て	這入って——そうして——泥棒が
這入ったの	て	這入って——
して	を	返事を
出来ぬので	も	話も
出掛けなさる	に	花見に
云いなさるから	と	勘定違いだろうと
舐めなさらんか	が	ばってんが——
しなければならんですか	を	借金を
したなあ	に	よかったに——
駄目ですばい	は	——猫は
捕りますか	ばかり	食うばかりで——
知らなかった	が	伝聞したが
証拠立てられたが	によって	行為によって
ならなくなる	が	油断が
して	を	喧嘩を
しないので	も	返事も
せず	も	運動も
する	を	返事を
なんなさるか	て	卒業して
褒めちゃくれず	て	勉強しても
しない	と を	朗吟すると 返事を
する	を	返事を
なさらんと	で	散歩で
あります	が	貯蓄が
買いなさらんか	で	——奥さん小遣銭で
したら	を	御話を
して	を	自炊を
つきますから	が	配当が
欲しいのかも知れない	だけ	困窮するだけに
云う	て	吹聴して
出来る方だそうです	の	大変学問の
しようかと	を	散歩を
暖かになるだろうと	で	運動でもしたら
下りる	へ	沓脱へ
要する	を	休養を
して	を	真似を
しかるべき	て	要求して
得ねばならぬ	を	休養を
乞うと	を	休養を
やるではないか	を	自弁休養を
要するは	を	休養を
して	を	座禅を
考え込んでいる	て	活動して
云うのが	と	工夫と
するのではない	て を	閉居して 修行を
読んで	は	らくは
挟む	を	故障を
見る能わざる	を	活動を
して	を	演説を
要求するがごとく	を	脱線を
勧告するごとく	が を	要求するがごとく 辞職を
過ぎん	に	注文に
評価してくれんのは	に	相当に
しているそうだ	を	大戦争を
組織して	を	混成猫旅団を
引っ掻いてやりたいと	て	組織して
云えば	か	戦争するかと
ならん	に	戦争に
寝ている	は	小供は
知らない	は	——細君は
して	を	大方居眠りを
云い	と	決心と
横わっているのを	が	一大心配が
するのは	を	戦争を
得た	から	観察から
見ると	て	綜合して
ある	に	逸出するのには
飛び出すかも知れない	て	迂回して
便なる	に	出入に
出たら	て	吶喊して
解く	を	警戒を
ある	が	懸念が
見せる	て	退治して
頼んでくるのも	に	助勢に
得る	を	安心を
せんではないか	も	心配らしい顔も
付かんからである	って	心配したって
起らぬと	は	三面攻撃は
得るに	を	安心を
欲する	を	安心を
起らぬと	は	三面攻撃は
取れぬから	が	心配が
得るに	を	答弁を
見て	て	想像して
御察し申す	が	心配されたそうだが
落つるからである	に	判然眸底に
要する	を	休養を
勤めている	を	代理を
逞しくしているのに	を	暴行を
うしている	を	舞踏会を
流しから	と	警戒すると
見たが	て	奔走努力して
ふると	に	左右に
せずに	も	身動きも
あるが	が	話が
なるまで	て	我慢して
なったり	に	御世話に
した	と	勘弁すると
行かぬ	が	合点が
して	を	算段を
等分して	に	左右に
嬉しがってるのも	て	等分して
しないと	に	等分に
立てる	を	区劃を
切り落す	は	左右は
受け取れない	と	写生としか
流行するかも知れない	から	話だから
考案して	を	いたずらを
いる	て	考案して
頼んだ	て	こせこせしてくれと
云うものの	と	——とは
出来ない	も	昼寝も
怠ったから	を	観察を
考えて	か	拝見しようかと
やるし	は	昼寝は
せんので	を	仕事を
しても	を	観察を
呈して	を	反応を
やる	を	真似を
する	を	御辞儀を
暑いじゃありませんか	で	ところで——
致した	など	昼寝などを
見えて	と	不足と
窮している	に	処置に
思って	と	露見したと
する	を	逆戻りを
しましょうかと	を	講釈を
忘れている	は	話は
出てくると	も	午睡も
見えて	と	同感と
困ります	と	催促すると
来ましたから	を	御馳走を
する	に	欠伸交りに
する	を	挨拶を
入れて	へ	懐中へ
見物しているように	で	手品でも
感嘆すると	て	見物しているように
収めた	に	懐中に
廻す	と	感嘆すると
する	を	懸念らしい顔を
なすったら	に	加減に
する	に を	事心配そうに 注意を
している	と を	感心すると 返事を
踏み潰してしまいまして	が	小供が
聞いていらっしゃい	から	今一説明しますから
出来る	も	代用も
見えるでしょう	に	寝かさずに——
している	を	問答を
する	を	御辞儀を
窮したと	から に	動作だから 応対に
見えて	と	窮したと
したぎり	を	返事を
注意した	に	心配そうに
要求する	は	長さ加減はと
する	を	返事を
激賞した	と	敬服すると
失敬しますよと	が	御入来だが
入れると	を	息を
聞くと	か	脱稿するのかねと
云う	と	早々呈出したまえと
要するのですからと	て を	安心させてやりたいのですが 研究を
思われない	と	沙汰とも
する	を	挨拶を
云うのです	と	影響と
報知しておいては主人は	に	論文脱稿前に
聞く	か て	研究かねと 報知しておいては主人は
しなくちゃなりませんが	も	実験も
合ったような	に	定義に
気が付いたと	と	矛盾だと
磨り潰しましたよと	が	磨りましたが——
つかぬ	の	見当の
云う	は	入り込みしは——と
向くとは	に	卒業後図書館に
云ったら	ね	勉強するねと
立ち寄ったんだと	に	拝借に
つける	よ を	是非入れたいよと 註釈を
磨り上げたら	じゃ	十年じゃ——
出来ませんから	が	実験が
及びませんよ	に	ご心配には
分らぬながら	を	談話を
途切れた	の	話の
切り付ける	ね	軽蔑なさるのねと
残っていないかも知れないが——	て に	経過しているから 記憶には
暮らしているんだよと	て	残っていないかも知れないが——
押して	ちゃ	謹聴しなくっちゃいけないよと
去る	と	回顧すると
した	を	息を
守って	を	約束を
取り掛る	に	失恋に
なろうと	に	御馳走に
した	を	返事を
した	を	工夫を
なさいよ	に	廃しに
なるんだから	に	大源因に
なるから	に	失恋に
して	を	挨拶を
なさいよ	に	廃しに
労れもある	の	旅の
寝てしまった	て	忘却して
拝見していて	から	識別しにくかったから
驚ろいたね	て	拝見していて
あった	も	失恋も
評すると	を	失恋を
思う	と	相違ないと
聞くようでござん	を	話を
告げたから	を	一段落を
ある者だから	なんか	結婚なんかは
むずかしがらないで	たり	憧憬したりしたり
しに	を	小便を
申し込んだのさ	ぜ を	晩だぜ—— 結婚を
申し込んで	を	結婚を
聞かない	を	返事を
進行させる	を	話を
して	に	山盛りに
待っていると	を	返事を
来ない	の	返事の
なって	に	僕同様失恋に
する	を	小便を
云っていた	て	引用して
始まる	が	議論が
する	を	弁難攻撃を
したり	を	合奏を
やって	を	交換を
出ると	に	散歩に
あって	が	蔵が
通したと	て	帰依して
するのか	を	話を
するのか	を	話を
やっていたんだっけ	んで	長どんと併んで
しておこう	て	割愛して
なる	に について	参考に 比較について
拭いているのさ	か	ものか——
始まって	が	談判が
記憶しているんだが	を	問答を
云う	に	小供心に
ならない	の	油断の
して	を	真似を
する	を	返事を
述べられた	を	観察を
やる	を	托販売を
発達してくると	が	独立心が
なる	て	発達してくると
ふう	て	開陳しておいて
目撃する	を	体操を
云い放つと	に	冷笑するように
している	を	体操を
思い出すのさと	と	拝見すると
行った	て を	豁然大悟して 講義を
きき終せて	を	講義を
儲かった	から	世話なんだから
及んで	に	露見に
及んだから	て に	一同連署して 嘆願に
括ったような	も	御奉行も
出来ず	も	挨拶も
告げました	を	落着を
知っていますよ	ねえ	感心ねえ
行かずとも	と	網羅し尽したとまで
云っては	を	不足を
寝ながら	を	挙止動作を
忘れて	も	難儀も
致しました	を	ご無沙汰を
する	を	御辞儀を
見えるが	と	評すると
穿いている	を	ゴワゴワするのを
する	を	挨拶を
云えば	と	朗読会と
する	を	返事を
やらないかと	を	創作を
出しましてね	を	行水盥を
しなければ	さえ	興行さえ
見えて	と	やる了見と
見たようだけれども	は	着付けは
見下ろしている	を	行水を
云う	と	感動したと
引く	に	合図に
磨いてる	で	実験室で
いましょう	を	御講釈を
分ります	と	説明すると
して	て	拡張して
見たくなったと	て	展開して
持って参りましたから	て	思いまして——稿本を
願いましょうと	を	御批評を
云って	と	拝見と
招待した	へ	朗読会へ
行って	に	避暑に
真面目くさって	と	留守でしたと
思ってるかね	と	意味だと
あるよ	が	相違が
渡す	ながら	嘆息しながら
受けると	を	質問を
窮する	に	返答に
云う	と	送籍と
打ち留めた	を	送籍君を
取除けですが	は	送籍は
願いたいのは	を	御注意を
なすった	を	苦心を
願おうと	から を	拝見したから 御批評を
だまっていなさい	よ	拝聴したよ
いましょう	が	是非伺が
渡った	て	一躍して
する	を	演説を
する	を	芝居を
云ったのは	と	賛成と
招待してから	へ	春朗読会へ
している	て を	招待してから 交際を
捧げる	て	利用して
聞かねばならぬ	を	雑談を
出た	て	失敬して
始めた	を	運動を
利いた	なんて	運動なんて
しろの	を	運動を
連発するようになったのは	を	注文を
心得ていいくらいだ	で に	病気で 連発するようになったのは
罹り出した	に	病気に
存して	に	記憶に
おらん	て	存して
推論すると	は	発達は
云うと	から	発達から
考えるのである	たり の	吹聴したり 大発明のように
して	を	病気を
すればからだが	を	病気を
あがると	を	往生を
落ちると	を	薨去を
ごねると	を	寂滅を
して	を	洋行を
いかん	って で を	往復したって 引き取った——呼吸では 今呼吸を
引き取って	ば	云わなければならん——潮を
出したのは	を	広告を
いる	ば	到着すれば
おらん	て	遭遇して
無暗に飛び込む	は	帰宅せん間は
生ずるに	が に対して を	機能が 狂瀾怒濤に対して 抵抗力を
死んだと	ば	換言すれば
出来ん	まで	使用せらるるまでは——
取り極めた	だけ	運動だけは
せんと	を	運動を
出来んのである	が	運動が
する	を	運動を
せぬ	を	運動を
変化する	は	評価は
起こす	を	変化を
きく	の	融通の
云った	を	運動を
したくなって	が	運動が
あるき廻ったって	を	往来を
利いた	を	運動するのを
抱く	か	運動かと
思う	と	説明しようと
不幸にして	の	御承知のごとく
して	から	源因から
横行するのは	て	運動させて
思う	は	運動は
取り去ると	を	刺激を
して	が	運動が
飛びつく	に	小供に
引き掻く	から	背面から
ならんから	に	運動に
前進すると	に	背面に
廻ってくる	と	前進すると
逃げ惑うのみである	へ	右往左往へ
追っかけるから	へ	右往左往へ
試みる	を	一大活躍を
ならん	に	実用には
試みた	て を	利用して 一大活躍を
過ぎん	が	活躍だが
出来ないから	が	急廻転が
出来なくなった	も	身動きも
やる	を	運動を
云う	と	蝉取り運動と
あると	が によって	関係が 解釈次第によっては
出来ないなら	が	今即答が
しても	は	蝉取り運動上は
見えて	に	運動に
見て	て	判断して
与える	に	蝉取り運動上には
かけられる	を	小便を
覘ってし	が	小便が
垂れんように	ばかり	小便ばかりは
ある	ば	研究すれば
する	が	集合だが
なる	に	妨害に
探偵する	て	一休息して
する	を	真似を
待ち合せていたら	と	休息しようと
見せてもらう	て	請求して
してから	を	御馳走を
下りる	に	下向に
落ちる	て	変化して
称して	を	運動を
過ぎん	は	左右は
一周するのである	は	運動は
ある	に	休息に
待つ	を	返答を
与えて	を	猶予を
しなければ	も	挨拶も
捨ておくのではないが	に	分に
やるのだ	を	芸当兼運動を
出来んのに	が	保証が
中止して	を	運動を
下りるより	て	中止して
して	を	深入りを
して	を	真似を
あっては	と	侮辱されたと
出来ない	は	退却は
している	を	話を
わからぬごとく	が	象徴詩が
呈出しない	を	反応を
あせるごとく	と	圧倒しようと
ひるような	が	進呈するがごとく
照り付けられた	に	運動中に
見えて	と	吸収したと
出来る	が	区別が
行うか	を	摩擦術を
出来兼ねる	も	安眠も
出す	で	猫なで声で——猫なで声は
撫でてくれる	て	誤解して
寄り添うと	ので	繁殖したので
出来た	が	真似が
取り扱が	の	——人間の
出来ん	ので	豹変したので
やるより	を	松皮摩擦法を
離れない	て	全滅しても
罹るかも知れない	て に	一工夫しておかんと 結果病気に
ある	が	思案したが
与えるなら	を	影響を
罹って	に	病気に
定めた	を	思案を
吐いている	て	屹立して
囃し立てる	に	嫉妬半分に
ある	は	教育は
断定したから	と	相違ないと
あって	から と	断定したから 前進すると
した	と	諒と
持ってるのだ	は ば	——人間は 繙けば——
挙行する	を	開校式を
した	を	大困却を
やると	を	開校式を
せよ	に	模写模型に
なれないが	に	志願兵にも
あっては	が	失礼が
ある	が	話が
あるなどとは	が	関係が
成立した	から によって	相談から 頓珍漢的作用によって
するがいい	でも	散歩でも
思ってはいけない	から	勘弁するから
抛り出した	て	製造して
しかるべきだろう	て	生長して
穿いて	て	発明して
費やしたのは	に	発明するのに
云う	と	結論と
費やしたって	に	発明に
云う	て	工夫して
なった	に	考案に
案ずると	を	由来を
出来る	が	一大発見が
始まる	が	競争が
出来なければ	が	競争が
やる	を	競争を
立ててくる	を	差別を
している	て を	露出して 談笑を
分らない	て	記述していいか
するのに	を	証明を
加える	を	忠告を
しないだけさ	を	病気を
する	を	挨拶を
信用しねえ	か	ものだか——
攻撃する	わ	交際わねえからねと
見渡すと	て	感心して
云う	と	活用しようと
求めた	を	同情を
起きないから	に	小便に
務めるのであろう	を	代理を
いる	も	三介も
たでている	て	ぼんやりして
並んでいる	に	左右に
見われた	て	辟易していると
存じます	て	一礼して
見て	を	湯加減を
上げてなと	や	——番頭さんや
した	は	記述は
出す	は	小供は
して	を	あいだ我慢を
つけた	と を	相違ないと 鑑定を
有しているに	ながら	逆上しながらも
始めたのである	を	喧嘩を
判断する	を	怒号を
知れん	て	解釈してくれるかも
分らんが	か	芝居かも
併べていたので	は	怒号は
しても	を	挨拶を
呼んだが	に	心中には
する	を	不便邪魔を
したそうだ	を	通行を
とらなければならんはずである	を	行動を
しようと	を	逆戻りを
癒す	を	病気を
よると	に	愚考に
免職して	て	依頼して
貰う	て	免職して
なれば	に	免職に
利かぬ	の	融通の
なるのである	と は	換言すると 免職は
して	を	病気を
云う	と	病気と
していると	を	病気を
落ちるだろうと	は	病気は
怠たっていると	を	観察を
起ったのかと	が	喧嘩が
抜けるように	へ	左右へ
適した	に	形容するに
分らない	て	同居しているのか
なったと	て	傑出して
出来ぬ	も	物色も
砕けよと	が	三介が
たまらん	て	説明しておいたが
装っていた	と	頂戴しようと
運動する	に	上下に
見ろだから	ば	了解出来れば
なる	に	放免に
懸って	て	予期して
出でたのではない	は	命令は
やったんだろう	を	速断を
さめない	が	逆上が
小事件かも知れないが	も	呈出するのも
答えた	て	吃驚して
云うんだ	と	比較研究と
知ってるか	とも	飲むとも——御前世界で
しらん	は	意味は
して	を	交際を
して	を	道楽を
しろといった	を	旅行を
すすめるなんて	を	道楽を
始められちゃあ	なんぞ	道楽なんぞ
食わせろ	を	御馳走を
して	は	道楽は
説明した	を	運動を
結んでおらぬ	は	交際は
ある	と	拝見すると
見えるから	て	密生しておらんので
取り囲んでいる	て を	屈曲して 北面を
出来ん	は	実行は
知らん	て	催促しているのに
いってはいけない	が	紹介仕るが
分からない	が	源因が
分からないと	が	源因が
迷惑する	に	処方に
する	を	話を
申し込まずに	も	抗議も
受くるに従って	を	教育を
企だてて	を	蚕食を
云う	と	蚕食と
取れんはずである	は	行動は
ある	が	ご案内であろうが
ある	の	教育の
する	を	談話を
違って	から	談話だから
違う	と	予期と
抜ける	て	横断して
哀願した	を	御取締をと
見ると	て	解剖して
話した	て	感心して
見たのだそうだ	を	喧嘩を
吠え立てると	て	廻転して
ある	の	安心の
見たくなる者だ	て	勘定して
ある	が	話が
出来にくい	の	我慢の
作って	を	刺激を
ならんから	に	刺激に
云う	と	安心だと
見ないと	て	応用して
握ろうとする	て	利用して
抱いて	を	了見を
推論して	て	参考して
見ると	て	推論して
ぶんなぐる	て	辞職して
する	を	辞職を
しかるべき	て	要求して
しかるべきか	て	使用して
出立している	から	仮定から
打ち崩して	を	仮定を
なって	に	運動に
しない	を	深入りを
入れて	に	勘定に
している	を	遊弋を
突こうとすれば	て	迂回して
向ったような	が	密猟船が
ならなければ	て	辞職して
する	を	出所を
思っておらん	を	使用するのを
記述する	を	戦争を
つくようにする	て	徘徊して
分らないくらい	が	戦争が
出る者だ	から	大概逆上から
読んで	と	逆上とは
ある	の	議論の
おったそうだ	て	循環して
云う話しだ	て	循環していると
あるが	は	増減は
感じて	を	欠乏を
冷たくなる	が	活動するが
すると	を	診断を
云う者である	と	逆上と
分配しなければならん	に を	平均に 逆上を
大分発明されたが	は	工夫は
ならん	て	速断して
重んずるのは	を	逆上を
途切れると	が	供給が
呼ぶに	を	逆上を
号したが	を	逆上を
しない	が	号したが
見れば	て	逆上であって
済むのは	に	入院せずに
悩ました	も	逆上術もまた
起るという	は ば	逆上は 便秘すれば
考えたのである	に	逆上するに
這入れば	ば	成功しなければ
したら	を	真似を
真似ると	を	態度動作を
なれる	て	間我慢していると
なって	に	伏しに
なっている	は	人為的逆上は
加えて	も	逆上も
立てて	を	発達を
分りにくい	て	逆上しているか
帰して	は	逆上は
謡われなくては	て と	逆上しても 逆上と
しておきたい	て	逆上であって
自慢しなくては	で	逆上でも
浴びせかける	て	発明して
発射するのだから	から	運動場から
行って	に を	戦争にも 間接射撃を
出すにおいてを	を	威嚇性大音声を
極そこいらを	の	煩悶の
生長する	で	営養不足で
禿げている	で	営養不足で
あるいていた	が を	極ってるが—— 往来を
つけている	が	相違ないが
しながらも	を	居眠りを
継続するならば	を	行動を
訴えて	を	不足を
変化するだろう	ば	継続するならば
食えば	を	砲撃を
継続しようと	を んで	戦闘を 予想せんで
苦心するのは	と	継続しようと
して	を	午睡を
取って来い	から	勘弁するから
悪くもあり	から	収縮したのだから
交戦するな	て	出馬して
出た	て	我慢して
追いかけて行く	ので	成功したので
すれば	を	深入りを
もって	を	談判を
結了した	は	交渉は
話さなければならん	を	是非大事件を
講じているのだろう	を	防禦策を
見えて	と	授業中と
しているのが	を	講義を
当った	て	出馬して
考える	て	輸入して来たように
申すのが	と	恕と
聴くと	を	放歌するのを
思う	て	晴々してよかろうと
なると	に	妨害に
謹聴していたが	を	講話を
笑った	て	謹聴していたが
説明する	を	意味を
交っていると	が	冷評的分子が
与えるからは	を	訓戒を
鑑定したから	は	逆上は
笑ったのである	から	鑑定したから
聞くのは	を	講話を
やんだ	は	講話は
ある	に	戦争に
云えば	と	戦争とさえ
行われたかも知れん	も	戦争も
属している	は	野蛮的行動は
持ち上がっても	が	騒動が
当っても	に	記するに
誘致する	に	戦闘線内に
しねえしねえ	か	降参しねえか
とってまた	て	相対して
くだけ	を	遊戯を
心得ているのだろう	と	運動遊戯と
かように	で	遊戯でも
利用して	を	運動術を
収めんと	て	利用して
うれしがる	て を	号して 逆上を
なさんとも	を	戦争を
抛りつける	に	所有者に
分らない	か	製造したか
云う	か	降参かと
仰ぐ	で を	戦争でも 供給を
行かん	が	製造するが
出る	に	反対に
あるのではない	に	遊戯に
存するのだから	に	戦争に
怒り出さなければならん	ば	騒動すれば
あらざれば	に	運動律第一に
支配せらるるならば	が	運動が
同じくしたであろう	ば	支配せらるるならば
取りとめた	て	製造してくれたので
す	は	変化は
よると	に	定義に
慣れている	に	排列に
挑む	を	戦争を
きいて	を	講義を
一言する	について	策略について
察した	と	相違ないと
玉拾いに	を	小供を
つらまえて	を	小供を
与える者である	は	逆上は
誇るに	を以て	逆上を以て
出来ないのである	て は	了見でなくては 仲間入りは
勤めたる	によって	命令によって
させるのは	を	学問を
許して下さい	から	注意しますから
許されると	を	闖入するのを
しているつもりである	を	大戦争を
振っているつもりである	を	逆上的敏腕を
乗り込んで来た	て	心配していると
とりかかる	に	談判に
加えておきますが	を	訓戒を
致しますが	は	注意は
せんと	を	注意を
やけて	ばかり	世話ばかり
願いたいと	を	御容赦を
する	を	挨拶を
告げた	を	落着を
貰いたい	て	記憶して
貰いたい	て	記憶して
するのは	を	小供を
同意する	と	相違ないと
照らして	と	層連続すると
なるんだから	て は	忽然豹変して 包含するは
する	を	後悔を
精読しなくては	まで	是非しまいまで
いかん	て	精読しなくては
したくなったから	が	散歩が
している	を	話を
訪問して	を	留守を
引き返す	て	訪問して
佇立しておらるる	て	決心して
歩み寄って	て	佇立しておらるる
入る	が	談話が
付けて	さえ	探偵さえ
拝聴したって	を	談話を
怒らるる	って	拝聴したって
聞いたのである	を	談話を
いる	に	落城するに
致す	を	御報知を
なるのも	も	逆上させるのも
わからないが	か は	作用か 廻転するのは
押し通す	で	冥頑不霊で
するのか	を	挨拶を
なる	に	心配に
いかんよ	と	用心せんと
出来る	が	安眠が
ありゃしないか	で	心配でも
出来やしない	も	碌々勉強も
命じてやる	を	閉鎖を
打ちゃっておけばいいさ	ね	小供だあね
障ったり	に	勉強に
名乗る	と	逆上家だと
達したのであるが	は	逆上は
係らず	も	談判も
ついたので	が	始末が
受けて	を	診察を
気が付いただけは	に	逆上に
おく	を	信用を
なさったらいいでしょう	で	運動でも
起ります	と	運動すると
始める	か を	拝見しましょうかと 診察を
終るのを	を	診察を
直す	を	病気だのを
一決して	は	相談は
なった	て	一決して
繰り返される	は	摩擦法はまた
思われるからである	て	拝見していると
くるのかい	か	鈴木か——
せんよ	も	意味も
合ったのを	から	着たてから
誂えたら	に	裁縫屋に
合わせるまで	か	我慢するかまたは
したり	を	喧嘩を
したり	を	自殺を
起るんだね	が	騒動が
せず	は	自殺は
やった	だって	喧嘩だって
しているさ	ばかり	毎日喧嘩ばかり
なる	に	妨害に
しても	て を	談判しても 喧嘩を
とれんのじゃないか	は	妨害は
云う	と	満足と
邪魔になる	が	下宿屋が
退去させると	を	下宿屋を
触る	と	退去させると
する	を	喧嘩を
思うのは	と	落着と
する	に	代議政体に
出来る	が	永久満足が
くらす	で	不満足で
求めるのじゃない	て を	変化させて 満足を
改良して	を	関係を
とろうとするのではない	て	改良して
求むる	を	安心を
観るのも	も	区別も
あって	が	——山が
する	を	工夫を
云う	と	満足だと
出来るのじゃないかしらん	が	作用が
訴えるだけの	か	閉鎖するかまたは
下げなければならんと	と	換言すると
恐れ入らなければならんと	に	恃む小供に
しようと	を	喧嘩を
得ろと	で を	修養で 安心を
反比例して	と	増殖と
至るだろうとは	て	反比例して
割り出されたる	から	統計から
見ると	て	打算して
ならんのみか	に	自慢に
やまずと	ば	挽回せずんば
知らん	て	占領しているのか
値する	に	尊敬に
して	を	真似を
登校して	つつ	曝露しつつ
教えている	て	登校して
立つ	て	刻して
垂れつつあるに	に を	授業以外に 訓戒を
云う	と より	影響と 反覆するよりも
与えつつある	て	解釈して
費やさねばならぬ	と	髣髴すると
流れたような	て	破裂して
いないのが	の	保証人の
なっても	に	訓戒に
揉み潰そうとした	て	心配し出して
あるく	を	往来を
あるくそうだ	て	勘定して
ある	の	教育の
思い留った	によって を	意見によって 喧嘩を
容れて	を	忠告を
聴く	など	忠告などを
見せるなどと	て	大悟して
及んだ	に	偵察に
製造せしめたる	て	談判して
見ようなどという	て	新調してまた
起した	を	了見を
連想して	を	観念を
結び付けた	て	連想して
して	を	昼寝を
垂れかかっている	が	左右が
光る	て	我慢して
思うが	と	調和しないと
食い込んでいるのだそうだ	のみ	侵蝕せるのみならず
すむ	で	露見しないで
したいくらいな	に	内済に
したら	を	質問を
回った	て	仰天して
感じた	に	徹骨徹髄に
出来ない	は	解脱は
つかんとまた	と	緊張すると
しているのか	て	研究しているのか
解釈してやれば	に	蒟蒻問答的に
演じているのかも知れない	ば	解釈してやれば
云う	と	研究と
喰わして	に	代理に
出来る訳だ	の	判断の
挑撥するの	を	自証を
ひねくっているなら	で	意味で
発明して	を	改良首きり器械を
飛んだ	て	発明して
なる	て	軽侮嘲笑しているつもりでも
なろう	は	自認するのは
した	を	あかんべえを
きまってる	に	腐爛するに
漂うている	て	一貫しているごとく
あるそうだが	て	解釈されて
ぼんやりしている	も	丹精も
達しているから	が て	作用が 構成されていて
掛けたんだろう	て を	彷徨しているのは 心配を
尽くされては	を	我儘を
与えて	を	訓練を
尽力している	に	按排するように
加える	を	鞭撻を
心得ている	の	道楽のようであるが
撓めて	が に	教育者が いたずらに
参りましたと	て	調練していると
告げ	を	平和克復を
若かん	か	歓喜何ものか
忍び	を	苦難を
従事し	に	一意戦闘に
告げんと	を	ど終了を
代表し	に対し	出征将校下士卒に対し
開催し兼て	を	一大凱旋祝賀会を
慰藉せんが	て	開催し兼て
仰ぎ	を	御協賛を
義捐あらん	て	御賛成奮って
云って	と	歓迎だと
云って	と	勧誘だと
あり	と	起因すと
得るの	を	校舎新築費を
命名せる	と	別冊裁縫秘術綱要と
附して	に	製本実費に
願い	を	御購求を
依っては	て に	蓄積して 校舎建築費に
御思召し	と へ	御寄附被成下と 本校建築費中へ
伏して	て	御分与被成下候て
ある	か	交渉か
して	に	再来に
生えるべし	に	学問には
向う	て	弄して
名づけて	を	此発作的活動を
構えている	だけ ほど	依頼でないだけに 七拝ほど
分りにくい	で	依頼ではないが
引き裂いてしまうだろうと	に	寸断寸断に
あると	が	意味が
究めようという	を	意味を
つけて	を	意味を
出来る	と の	解釈しようとすれば 解釈の
とれる	は	意味は
つけたがるのである	を	意味を
食って	を	仁参を
係らず	に	吹聴するにも
わからん	で	講義でも
分らんからである	と	尊敬すると
つけて	を	註釈を
沈んでいる	に は	冥想に ——主人は
乞う	を	案内を
頼んでいる	を	案内を
した	を	挨拶を
買いに	を	洗濯石鹸を
飛び上がって	から	沓脱から
力めているんだ	を	修養を
出来なくなった	が て	返事が 修養して
逢いたいと	に	是非君に
控えている	て	端坐して
聞いて	を	講釈を
出来ない	さえ	挨拶さえ
出来かねますから	が	いやそれでは御挨拶が
真似ている	に	加減に
していたが	を	立見を
出た	に	遠慮せずに
する	を	噂を
致すそうで	を	御邪魔を
存じておりました	と	拝聴致そうと
忘れてしまって	も	朝鮮仁参も
する	を	返事を
着けた	て	恐縮してまた
計って	を	呼吸を
伴れてあるいてもらわんと	に	——迷亭にでも
した	を	長生きを
きくし	し	出席するし
するだけでも	を	東京見物を
出来るが	が	我慢が
驚いた	て	応用して
思っていたが	ほど	話ほどではなかろうと
聞いて	を	由来を
切らすのも	を	話を
がすな	ので	見るので——
戴くような	が	参詣人が
見せて	を	実験室を
求める	を	賛成を
致した	に	狼狽せぬように
あらっし	で	御承知でも
云われた	と	求放心と
しているんですから	ばかり	修養ばかり
しているんだから	に	置き去りに
やったら	で	事で——御前など
あるから	が	約束が
して	を	挨拶を
主張する	を	修養を
云う	と	学問と
得られやしない	は	満足は
ある	は	学問は
及んで	て	訪問して
云う	と	修養と
してね	を	議論を
あるんだから	ので	発明したので
寝てしまったのさ	て	安心して
やろうと	て を	奮発して 修養を
した	を	怪我を
云うよ	て	顛倒して
逢っちゃ	に	いたずらものに
分りゃしない	か	いたずら者だか
云う	と	南蔵院と
いる	が	隠居が
いる	の	隠居の
するんだね	を	座禅を
あるき廻った	て	号して
善し悪ししだねと	も	熱中するのも
助からない	から	併発したのだから
任じている	て	号して
とられたよ	を	不足税を
取り合せは	の	朝鮮仁参の
煎じて	を	朝鮮仁参を
反覆読誦した	をもって	尊敬をもって
翫味したかと	て	心労して
合併した	の	心配の
響いたと	に	沓脱に
乞わずに	も	案内も
動かん	のに	出張するのに
している	を	挨拶を
なって	に	深夜御来訪に
云うんで	と	出頭しろと
した	を	御辞儀を
したのだろう	を	早合点を
立っている	が	相違ないが
云う	と	探偵と
至っては	に	尊敬するに
してくれないのだとは	て	軽蔑して
告げた	を	落着を
遅くなると	て	弄して
見習おうとした	て	感服して
思い込んだ	と	相違ないと
ざれ言にもせよ	が	記述が
もって	を	主宰を
表する	を	同情を
すれば	と	卜すると
突き合せて	に	同室内に
添えている	は	作用は
なる	と	行為と
追払われずに	から	し出かさんから
ならん	て	検査しなくては
勘定していては	て	比較して
出来そうにもない	て	勘定していては
出るのである	から が	解釈するから 結論が
磨いている	で	弁当持参で
つかみ合い	て	集合して
ある	の	分別の
使役して	て	濫用して
働いて	て を	使役して 乱暴を
描き出した	を	心的作用を
得ぬ	さえ	差別さえ
訴えながら	て に	提供して 思索力に
達せずして	に	結論に
疑う	か	記述し得るかと
起したのを	を	了見を
しない	も	ぎり返事も
しないのは	を	返事を
うるさくなる	が	返事が
おらんようだから	て	珍重して
する	を	注意を
行ってしまった	て	注意しても
始めたのである	を	掃除を
しているからである	を	掃除を
かたちづくって	を	連想を
至っては	の	掃除の
試験して	とも	是非とも
見たくなる	て	試験して
見れば	て	試験して
きまってる	に	失望するに
受取るまでは	を	失望を
してやろう	を	催促を
起させるのが	を	同情を
出来る	が	想像が
蒙って	を	襲撃を
ある	の	感応の
ぬすみに	の	貧の
喚起する	を	注意を
生じないようだ	て も	確信しているのだが 影響も
出来る	が	御化粧が
なるばかりだ	に	ご使用に
引っ張られるから	に	左右に
濡れる	が	我慢するが
云わない	は	坊やは——
施している	を	御化粧を
出来上った	から	摩擦したから
ととのった	が	装飾が
してしまった	を	掃除を
承わる	を	返事を
うる	に	襲撃に
して	を	覚悟を
した	を	うんと返事を
寝込まれつけているから	て	安心していると
出来ないと	は	油断は
食わん	に	我儘者には
泣いているのである	て	予想して
云うが	て	逃亡して
して	を	真似を
戻るのである	が	整列したのであるが
なると	が	精神修養が
ならずに	に	免職にも
なる	に	免職に
泣く	が	小供が
云えば	て	翻訳して
する	を	喧嘩を
追っ懸けてあるいていたと	も	韓国統監も
している	を	昼寝を
おらん	て	露出して
云う	と	探偵と
受けた	を	教育を
行かない	に	始末に
してもらいたい	を	遠慮を
しなければ	を	遠慮を
もって	を	虚構を
している	を	宙返りを
するのは	を	宙返りを
極めた	を	変調を
告げると	を	一段落を
はじめる	を	通り掃除を
したごとく	を	先日紹介を
なると	に	出御に
つかん	の	見当の
おって	が	隠居が
死んだ	が	隠居が
頼まれた	を	当分留守番を
引き払う	を	隠居所を
狂ってくる	て	処理していると
ある	て	存して
変化し	が	流行が
大きくなる	は	生長するどころではない
片付ける	て	承知しているだけで
云うと	を	定義を
苦しんでいる者だと	て	捏造して
窮しているとは	に	処置に
知らず	て	窮しているとは
おえないのは	に	始末に
癒せる者ではないと	で	薫陶で
している	て	専有して
保っていたのが	を	平均を
受けたので	を	襲撃を
煩わしたい	を	御再考を
我慢していたが	て	掠奪されて
食ってしまう	て	我慢していたが
試みて	を	一大活躍を
とりかかる	に	掃除に
取払う	て	寄寓していたのを
したような	と を	注意しないと 火傷を
執る	に関して を	教育に関して 絶体的放任主義を
見ているだろう	て	出奔しても
知らないようだ	と	拝見すると
しかるべきのを	て	赤面して
思っている	て	履行して
済ましたる	を	朝食を
及んだ	に	出頭に
済ませて	を	食事を
する	を	支度を
出したのだろう	を	欠勤届を
驚ろいた	に	発明に
取りかかる	に	仕事に
乞わずに	も	案内も
して	を	喧嘩を
したから	を	御無沙汰を
しないんです	も	返事も
おこすと	から	心配だから
あるの	て	勧めているんでしょう——
したんですが	を	話を
あるし	は	小供は
聞いていると	を	談判を
しているって	を	決心を
死ぬわねえ	って	決心したって
落第してしまったわ	けれども	是非及第するつもりだったけれども
出来る	で	決心で
あるの	が	貯金が
貰うといいんですよ	で	意見でもして
なすったわ	て を	落ちついていれば—— 演説を
して頂いたの	て を	招待して 演説を
聞いていてよ	て	感心して
なさる	を	話を
片付ける	を	仕事を
承	を	御話を
仕ると	を	御話を
笑うと	と	話だと
辟易させる	て	一喝して
していたが	を	苦笑を
見えて	と	納得したと
して	を	相談を
したら	で を	——で 相談を
したんですね	を	相談を
立たないんですって	に	益に
受合ったそうです	と	ご安心なさいと
したそうです	を	降参を
開いたんですが	で を	——でも 相談を
騒ぐんだって	で	夜昼交替で
見えないので	が	験が
する	を	質問を
致したのは	な	かような御話を
通って行かないで	を	近道を
なって	に	御記憶に
処理していただきたい	で	了見で
来たの	に	傍聴に
すれば	を	御化粧を
すれば	を	御化粧を
成立しやしないわ	は	関係は
逞しくしていると	について を	結婚事件について 弁論を
開いて	て	謹聴しているとん
寄すべき	を	同情を
持ちかけた	を	相談を
抛り出した	ながら	挨拶しながら
出来ないわ	は	真似は
云いながら	と	出頭しろと
なおいけないわ	ちゃ	散歩しちゃ
なってよ	に	免職に
見ろ	て	発達して
おっしゃい	から	無教育なんですから
なさい	で	真似でも
しろ	を	真似を
しないわ	って	落第したって
起因するかを	に	心理作用に
研究する	か	起因するかを
択ばないと	に	研究するには
している	を	話を
出来たのであろう	が	拝見が
出来る	が	経験が
出来ない	は	学問は
恐縮している	が	乱暴者が
する	に	自慢に
具えているかと	で	運動場で
しでかすかも知れない	を	ストライキを
遠慮すればいいのに	ば	遠慮すればいいのに
遠慮すればいいのに	で ば	下宿屋で 遠慮すればいいのに
出来なかったのである	て	連結して
ある	が	用事相談が
おらんが	て	発達して
受け取られない	のみ	遠慮のみとは
出来ない	が	鑑定が
しないからと	は	他言は
する	を	判断を
借したの	で	下宿料でも
なると	て に	廃して 投函役に
借してしまったんです	って	いいって——
ありゃしません	も	交際も
したんだい	で	了見で
なると	に	退学にでも
寝られないんで	て	心配して
なるでしょうか	に	退校に
なろう	に	退校にでも
なるでしょうか	に	退校に
しないが	を	真似を
ならないように	に	退校に
及んでいる	に	哀願に
受けて	を	尊敬を
書くのは	を	いたずらを
つき	が	見当が
かけるのであろう	を	質問を
思うと	か	辞職するかと
して	を	矛盾を
起すからである	が	反響が
なるのは	に	退校に
なるのとは	に	免職に
なったら	に	退校に
するのは	を	嘆息を
見たり	として	賦税として
発表している	から	珍重されないから
困るのが	ば	解剖すれば
云うだろう	と	侮辱したと
思うのは	と	侮辱したと
必用であるのみならず	が	覚悟が
出来ない	は	交際は
した	を	失礼を
もって	を	心配を
はちきれんと	が	充満せるがごとく
伝って	が	心配が
活動するのである	の	反射作用のごとく
窮している	に	処置に
つく	と	監督と
困らしたりした	て	煽動して
つく	と	監督と
信じているらしい	と	相違ないと
出立している	から	仮定から
冷淡になるだろう	に	心配には
なられん	て	自覚して
後悔するとも	とも	心配するとも
得られんのである	とも は	後悔するとも 成功は
放逐するであろう	に	居住地以外に
思った	と	談判不調と
よると	に	弁解に
始めて	を	稽古を
与えるからである	を	摩擦を
して	を	会釈を
なって	て	方々散歩して
出掛けませんか	に	冒険に
聞いていた	を	話を
したらいいでしょうと	が	心配なんですが
廻る	て	失敬して
始める	を	協商を
あらわせないですと	で	超絶的曲線で
した	を	挨拶を
していても	を	嘆願を
出来ますか	は	学問は
するよ	を	質問を
するんでしょう	を	質問を
訳してやらないと	は	小供は
構わないが	て	安心していれば
食うような	を	西洋料理を
あるんだ	が	手分けが
来たんだ	て に	恐縮して 相談に
なるでしょうかって	に	退校に
なるんです	に	退校に
殺してしまいますよ	ちゃ	心配させちゃ
ある	の	分別の
して	を	いたずらを
しようと	に を	是非いっしょに 散歩を
出ようじゃありませんか	とも	——とも
して	を	運動を
奪われては	に	勝負に
了してこそ	において	度外において
行こう	て	謙遜して
出来ている	が	拝見したのだが
命ずる	を	退去を
せず	も	身動きも
あらわれる	が	嗜好が
云っても	て	代表していると
評してもよかろう	に	一言に
引きずり出して	か	了見か
始めたのである	を	いたずらを
とって	を	行動を
したじゃないか	を	待ったを
したら	なんか	座禅なんか
云うのです	と	心配だと
持って来てもまた	へ	下宿へ
云う	と	だき心と
つける	に を	談話にも 関係を
買うさ	て	奮発して
して	に	一喝に
するがいいと	を	真似を
したいから	に	参考に
あるいておりますが	など	往来などを
始まったようだ	が	話が
切り上げようじゃないか	に	加減に
して	を	兵式体操を
云うが	と	突進するんだと
している	を	奉職を
聞いて	を	話を
しろ	を	勘定を
負けてるから	て	勘定しなくっても
はずして	と	失敬すると
している	を	計算を
つづける	を	話を
厳重にしましたから	を	制裁を
飛んで行ってしまう	は	話は
おえない	に	始末に
洩らした	を	大息を
かけた	を	質問を
連れて	を	小供を
して	を	是非結婚を
分からないですから	ば	開拓しなければ
きいているのです	を	経験譚を
知れては	で	遊戯三昧で
したのは	を	説教を
はじめるまでには	を	稽古を
したよ	を	大分苦心を
溜めたから	て	用意して
加えられます	を	制裁を
加えられる	を	迫害を
表した	を	同情を
蒙りたいね	だけ	天才呼ばわりだけは
して	を	毎日散歩を
して	を	散歩を
軽蔑されても——	て	譴責されても
絶息しても——	て	軽蔑されても——
受けても	を	処分を
いられないと	ばかり	——、こればかりは
思いました	て	絶息しても——
出来るような	が	想像が
買いました	て	奮発して
云って	と	病気だと
こらした	を	祈念を
見ると	て	辛抱して
しにくくって	が	話が
見える	と	辛抱し切れなくなったと
している	を	挨拶を
し切れなくなったと	が	我慢が
致しましょう	が	ご注文ですが
出ました	を	下宿を
申し込むと	を	抗議を
喰わせる	を	正面攻撃を
しました	を	注意を
張った	よ	難渋するよと
及びません	に	御心配には
帯びています	て	反射して
出せませんよ	て	徘徊しているんだから
号して	など	沈澱党などと
喜んでるのが	て	号して
とっている	て	退去して
つづける	を	談話を
帰りつくして	から	散歩から
帰する	が	計画が
まごついている	の	探偵のように
きくと	を	話を
進行したまえと	を	話を
慰藉した	と	進行したまえと
つづけるつもりである	て を	慰藉されなくても 話を
計算して	て	勘定して
ふかして	て	計算して
渡り切って	を	——紺屋橋を
あった	に	按摩に
ありません	より	降参するより
していたのが	を	話を
して	を	返事を
中止して	を	話を
見ています	て	中止して
出たくて	へ	往来へ
出て	へ	往来へ
帰りました	へ	下宿へ
帰って	へ	下宿へ
している	を	問答を
しないか	か	露見するか
する	を	仲間入りを
やり込めた	じゃ	調和しないじゃないかと
しないが	は	調和は
かける	を	質問を
している	を	自炊を
出た	に	散歩に
出来ない	の	油断の
云うので	と	相違ないと
疲労したと	て	弄し過ぎて
見えて	と	疲労したと
登山しているのさ	て	用意して
かいて	を	胡坐を
帰って来たよ	て	逗留して
なったんですか	に	御馳走に
申し込んだ	を	降参を
している	を	昼寝を
ある	が	話が
流れて	が	垂涎が
あるかい	が	話が
するんだったかな	を	ヴァイオリンを——
つかない	が	見当が
進めた	から	鑑定したから
弾くがいい	て	安心して
出来ない	が	話が
見下せる	に	一目に
あって	で	平地で——そうさ広さは
なくなって	も	区別も
起して	を	反響を
撫でおろす	と	安心したと
する	を	真似を
おるまい	て	しては——
云うので	と	解釈しようと
はじめる	を	震動を
見廻	を	一座を
云った	て	拝聴していたんだよと
聞くかと	で	講釈でも
出ないので	が	質問が
加えると	を	酷評を
延びて	が	結婚が
あるじゃないか	が	約束が
ありゃしません	なんか	約束なんか
こめた	を	同情を
及んでくるよ	が	影響が
かけて	を	御心配を
やったのかね	を	秘密結婚を
ならない	の	油断の
たたない	て	結婚して
かける	と を	結婚したんだと 質問を
貰ったんです	に	結婚祝に
かかって	が	探偵が
云う	と	探偵と
述べられた	について の	探偵について 大議論のように
抜くのが	を	懐中を
云う	と	探偵と
襲撃したって	の	探偵の
怖くはありません	って	襲撃したって
使う	を	探偵を
云えば	と	探偵と
呈出した	を	質問を
答える	から	解しないからでしょうと
答える	から	いらいらするからさと
始めた	を	議論を
よると	に	解釈に
強過ぎるのが	の は	自覚心の 探偵的傾向は
名づけるのは	と	自覚心と
弄する	を	大議論を
比し	を	探偵を
くると	も	探偵も
云うのだよ	から	探偵でないから
云うのは	と	自覚心と
コセつくばかり	が	行為言動が
出来ん	から は	商売だから 探偵は
離れる	が	心配が
ならざるを得ない	が	勢自覚心が
ならざるを得ない	が	自覚心が
得ないのは	も	安心も
云い出した	と	解釈だと
得ている	は	説明は
充満している	をもって	意識をもって
張り切れそうになっている	が も	存外自覚心が 行為も
聞いたと	を	話を
済んで	が	御馳走が
あるだけ	が	自覚心が
おだやかになるなどと	が	交際が
圧迫するのだから	は も	喧嘩は 喧嘩も
増してくるんだねと	が	自覚心が
上ってるから	は	喧嘩は
考える	て	利用して
役に立たせると	て	変化して
縛せられ	に	貧に
すれば	さえ	利用さえ
たたくと	と	ひやひやと
いらないから	は	遠慮は
生れる	て	熟考して
出来るのは	の	返事の
云う	と	神経衰弱と
発明されてから	が	病気が
聞くが	から	議論だから
聞いていろ	から	議論だから
有している	は	自殺クラブは
増加して	が	自殺者が
主張する	を	自殺を
存在しない	より	自殺より
積んで	が も	大分研究が 自殺も
授けるようになる	を	自殺学を
出たいくらいの	に	傍聴に
展開して	を	自殺を
しても	て	展開して
しますね	を	講義を
している	を	保護するのを
あるく	て	撲殺して
限るのさ	て	大概自殺してしまうから
云えば	と	予言と
認定したがる	て	束縛せられて
進める	を	話を
やる	を	水泳を
した	を	いたずらを
聞いた	と	いたずらと
撞く	に	合図に
なるんですから	に	御贔屓に
及びません	に	御遠慮には
あって	が	問答が
なると	に	皆済に
返して	に	勘定せずに
なる	に	参考に
忠告したら	と	謝罪しろと
あずかりたいですね	に は	御容赦に 謝罪は
云う	と	変遷と
あせる	と	競争しようと
卜すると	て	達観して
なる	が と	結婚が 卜すると
主張し出して	が	生存者が
するようになる	て	主張し出して
買いながら	を	喧嘩を
侵してやろうと	と	固守すると同時に
制さ	の	親子別居の
済むのだが	から	主張しないから
張れるだけ	を	我儘を
払ったりする	を	下宿料を
払えばこそ	を	尊敬を
つれて	に	発展に
のびて行くから	と に	発展と 無制限に
化ける	て	号して
分ってくる	は	夫婦雑居は
云った	な	心配だなと
発達せしめなければならん	と	保持すると同時に
執行するのは	を	結婚を
叩いた	と	反対ですと
洗錬するのは	を	同情を
なります	に	関係に
あるからだろう	が は	一致が 繁昌するのは
主張する	を	非結婚論を
不道徳になる	が て	婚姻が 発達して
思われないんです	に	直覚的に
思われなければ	に	直覚的に
かき散らしたのだね	を	乱暴を
得た	て	欲して
した	を	修行を
起して	を	神経衰弱を
つかなくなった	が	始末が
罹って	に	アルコール中毒に
書いてある	と	紹介すべしと
あらずや	に	誘惑に
ありません	ば	拝聴すれば
した	を	返事を
せず	も	挨拶も
行きました	て	雇うて——
違います	が	大変信用が
いい	で	信用で
いうと	ね	軽便信用だねと
貰うてくれと	て	是非貰うてくれ
する	を	返事を
するです	は	御礼は
周旋してもいいです	に	御礼に
願いましょう	を	是非周旋を
あります	が	持参金が
招待しますが	に	披露会に
出てくれるでしょうねと	が	招待しますが
あるから	も	関係も
乱す	を	算を
寝る	は	小供は
する	を	対面を
し切れなくなって	が	我慢が
帰臥してもいいはずであった	て に	頂戴して 無何有郷に
帰するそうだ	に	自殺に
すると	を	油断を
出した	て	決心して
重ねて	に を	我慢に 我慢を
運ばせてゆくと	に	加減に
出したと	と	驚ろかないんだと
使う	を	行水を
使えば	を	行水を
使おうなどとは	を	行水を
罹っているのは	に	拷問に
つかない	が	見当が
